############
#          #
#   P    X##
#          #
#######   X#
#  O ##    #
#    ##    #
#          #
# X        #
#  X     OO#
#    X   OO#
############