#################
#               #
#               #
#    OO     X   #
#       P       #
#    X          #
#               #
#################