##########
#        #
#  O XP  #
# X     O#
##########