#########
#   #   #
#   X   #
# #XPX# #
#   X   #
#   #   #
#########