#########
#       #
#   X   #
#  XPX  #
#   X   #
#       #
#########