#########
#       #
#   O   #
#  OPO  #
#   O   #
#       #
#########