#####################
#         #O ##     #
#         #   #     #
#   ###   #   #O#   #
#        ##  ###   ##########
## # # # ##         #      ###
#         #         #        #
#         ###   #####OO#     #
# # # # # #         #####    #
#                            #
#  P           ##            #
##############################
