#####################
#    P    #  ##     #
#  X X X  #   #     #
#   ###   #   # #   #
#        ##  ###   ##########
## # # # ##         #      ###
#         #      X  #        #
#         ###   #####  #     #
# # # # # #         #####    #
#                            #
#  P           ##            #
##############################
