#####################
#         #O ##     #
#  X X X  #   #     #
#   ###   #   #O#   #
#        ##  ###   ##########
## # # # ##         #      ###
#         #      X  #        #
#         ###   #####OO#     #
# # # # # #         #####    #
#   111111                   #
#  P           ##            #
##############################
