#####################
#    P    #O ##     #
#  X X X  #   #     #
#   ###   #   #O#   #
#        ##  ###   ##########
## # # # ##         #      ###
#         #      X  #        #
#         ###   #####OO#     #
# # # # # #         #####    #
#                            #
#  P           ##            #
##############################
